{
	"width": 26,
	"height": 18,
	"scale": 25,
	
	"layout": [ "..........................",
				"..........................",
				"......................R...",
				"R.........................",
				"..........................",
				"..........................",
				"..........................",
				"...............R..........",
				"..........................",
				"..........................",
				"..........................",
				"..........................",
				"....R.....................",
				"..........................",
				"...............R..........",
				"..........................",
				"..........................",
				".........................." ]
}